Map:
------------
------------
------------
------------
------------
------------
QQQQQQQQQQQQ
------------
############
------------
------------
------------
------------
------------
------------
------------
------------
------------
------------
------------
------------
------------
------------
------------
------------
Map/

Meta:
Name: Central Mass
Hardened: #
Teleport: Q
Meta/

Legend:
#) red-block.png
Q) green-block.png
Legend/